ARQUIVO DE DADOS GERAIS     : dger.eas    
ARQUIVO DADOS DOS SUBSISTEMA: sistema.eas 
ARQUIVO CONFIG HIDROELETRICA: confh.eas   
ARQUIVO CONFIGURACAO TERMICA: term.eas    
ARQUIVO DADOS CLASSES TERMIC: clast.eas   
ARQUIVO ALTERACAO USIN HIDRO: modif55.eas 
ARQUIVO EXPANSAO HIDROTERMIC: expansao.eas
ARQUIVO DE VAZOES           : vazoes.dat  
ARQUIVO DE POSTOS           : postos.dat  
ARQUIVO DADOS USINAS HIDRO  : hidr.dat    
ARQUIVO USOS ALTERNATIVOS   : dsvagua.eas 
ARQUIVO AUXILIAR DA FCF     : cortesh.eas 
ARQUIVO FUNCAO CUSTO FUTURO : cortes.eas  
ARQUIVO NEWAVE DADOS CONFIG : newdesp.eas 
ARQUIVO INPUT SIMUL PARAIBA : shp.eas     
ARQUIVO PEQUENAS USINAS     : pequsi.eas  
ARQUIVO DE PATAMARES MERCADO: patamar.eas 
ARQUIVO C/TEND. HIDROLOGICA : eafpast.mlt 
ARQUIVO RESTRICAO ITAIPU    : itaipu.dat  
ARQUIVO DEMAND SIDE BIDDING : bid.dat     
ARQUIVO CARGAS ADICIONAIS   : c_adic.dat  
ARQUIVO PERDA DE TRANSMISSAO: loss.dat    
ARQUIVO RELATORIO           : suishi.rel  
ARQUIVO RESUMO OPER MENSAL  : diretor.csv 
ARQUIVO RESUMO SUBSISTEMA   : subsis.csv  
ARQUIVO RESUMO USI HIDROELET: usihid.csv  
ARQUIVO RESUMO USI TERMICA  : usiter.csv  
ARQUIVO OUTPUT PARAIBA SUL  : pbsuishi.csv
ARQUIVO POTENCIA CONFIABILID: pdisp.dat   
ARQUIVO FATOR G.TERMICA MIN.: gtminpat.dat
ARQUIVO PAR. ALTO TIETE     : atiete.dat  
ARQUIVO PAR. CURVA ARM MIN  : curva.eas   
ARQUIVO GER. TERM. / CLASSE : gerter.csv  
ARQUIVO DE INTERCAMBIOS     : inter.csv   
ARQUIVO ENERGIA FIRME/ASSEG : efga.csv    
ARQUIVO DESP. TERM. ANTEC.  : adterm.dat  
ARQUIVO AVERSAO A RISCO SAR : sar.dat     
ARQUIVO AVERSAO A RISCO CVAR: cvar.dat    
ARQUIVO CURVA GUIA DE OPER. : cguiaop.dat 
ARQUIVO VMAXT SAZONAL - E.F.: vmaxtsaz.dat
ARQUIVO VAZMINT PERIODO PRE : vazmintp.dat
ARQUIVO DE DADOS RES EQUIV  : ree.dat     
ARQUIVO RESUMO RESV EQUIVAL : ree.csv     
ARQUIVO RESUMO SIN          : sin.csv     
